0000000000000000000000000000
0322222222222222222222222230
0202000002000000002000002020
0202222222222222222222222020
0202020202020000202020202020
0202020202020000202020202020
0202020202020000202020202020
0222222222222222222222222220
0200000002000000002000000020
0200000002000000002000000020
0200000002000000002000000020
0200000002222222222000000020
0200000002000110002000000020
0200000002011111102000000020
1211111112011111102111111121
0200000002011111102000000020
0200000002000000002000000020
0200000002222222222000000020
0200000002000220002000000020
0200000002222222222000000020
0200000002000000002000000020
0200000002000000002000000020
0200000002000000002000000020
0222222222222112222222222220
0202020202020000202020202020
0202020202020000202020202020
0202020202020000202020202020
0202222222222222222222222020
0202000002000000002000002020
0322222222222222222222222230
0000000000000000000000000000