0000000000000000000000000000
0222222222222002222222222230
0200002000002002000000000000
0300002000002002000000000000
0200002000002002000000000000
0222222222222222222000000000
0200002002000000002000000000
0200002002000000002000000000
0222222002222002222000000000
0000002000001001000000000000
0000002000001001000000000000
0000002001111111111000000000
0000002001000110001000000000
0000002001011111101000000000
1111112111011111101111111111
0000002001011111101000000000
0000002001000000001000000000
0000002001111113111000000000
0000002001000000001000000000
0000002001000000001000000000
0222222222222002222000000000
0200002000002002000000000000
0200002000002002000000000000
0322002222222112222222222230
0000000000000000000000000000